....................
.............X#.....
........#######.....
...#####..X.........
..........#......X..
P#........M...M..#E.
##..################
