........X...........
....#...#...#.......
#...........M.......
...#.....X..#.......
......#######.......
..#..M........#.....
P#...#.....#.....#E.
##...............###
