....................
.............M......
.............#......
.......#....#..#....
P.......M.........XE
###..###############
