....................
....................
............M.......
............#.......
......#.............
..#..M........#.....
P#...#.....#.....#E.
##...............###
