....................
.............M......
.............#......
.......#....#..#....
P.......M..........E
###..###############
