....................
....................
....................
P#........M...M..#E.
##..###.###.########
