....................
....................
....................
P#...............#E.
##..###.###.########
