....................
....................
.............#......
.......#....#..#....
P..................E
###..###############
