....................
....................
....................
....................
......#.............
..#...........#.....
P#.........#.....#E.
##...............###
